[Map]
tileSheet=Assets/World/NecroDungeon/TileSheet.png
name=NecroDungeon
tileWidth=16
tileHeight=16
scaleX=4
scaleY=4
mapWidth=30
mapHeight=20
tiles=
3,3,3,3,3,3,3,3,3,3,3,3,3,3,3,3,3,3,3,3,3,3,3,3,3,3,3,3,3,3
3,9,10,10,10,10,10,10,10,10,10,10,10,10,10,10,10,10,10,10,10,10,10,10,10,10,10,10,14,3
3,13,2,2,0,2,2,2,0,2,2,2,0,2,2,2,0,2,2,2,0,2,2,2,0,2,2,2,4,3
3,13,2,2,2,2,2,2,2,2,2,2,2,2,2,2,2,2,2,2,2,2,2,2,2,2,2,2,4,3
3,13,0,2,2,2,2,2,2,2,2,2,2,2,2,2,2,2,2,2,2,2,2,2,2,2,2,0,4,3
3,13,2,2,2,2,2,2,2,2,1,2,2,2,2,2,2,2,2,1,2,2,2,2,2,2,2,2,4,3
3,13,2,2,2,2,2,2,2,2,2,2,2,2,2,2,2,2,2,2,2,2,2,2,2,2,2,2,4,3
3,13,2,2,2,2,1,2,2,2,2,2,2,2,1,2,2,2,2,2,2,2,2,1,2,2,2,2,4,3
3,13,0,2,2,2,2,2,2,2,2,2,2,2,2,2,2,2,2,2,2,2,2,2,2,2,2,0,4,3
3,13,2,2,2,2,2,2,2,2,2,2,2,2,2,2,2,2,2,2,2,2,2,2,2,2,2,2,4,3
3,13,2,2,0,2,2,2,0,2,2,2,0,2,2,2,0,2,2,2,0,2,2,2,0,2,2,2,4,3
3,13,2,2,2,2,2,2,2,2,2,2,2,2,2,2,2,2,2,2,2,2,2,2,2,2,2,2,4,3
3,13,2,2,2,2,2,2,2,2,2,2,2,2,2,2,2,2,2,2,2,2,2,2,2,2,2,2,4,3
3,13,2,2,2,5,2,2,2,2,2,5,2,2,2,2,2,5,2,2,2,2,5,2,2,2,0,2,4,3
3,13,2,2,2,2,2,2,2,2,2,2,2,2,2,2,2,2,2,2,2,2,2,2,2,2,2,2,4,3
3,13,2,2,2,2,2,5,2,2,2,2,2,5,2,2,2,2,2,5,2,2,2,2,5,2,2,2,4,3
3,13,2,0,2,2,2,2,2,2,2,2,2,2,2,2,2,2,2,2,2,2,2,2,2,2,2,2,4,3
3,13,2,2,2,2,2,2,2,5,2,2,2,2,2,5,2,2,2,2,2,5,2,2,2,2,5,2,4,3
3,12,6,6,6,6,6,6,6,6,6,6,6,6,6,6,6,6,6,6,6,6,6,6,6,6,6,6,7,3
3,3,3,3,3,3,3,3,3,3,3,3,3,3,3,3,3,3,3,3,3,3,3,3,3,3,3,3,3,3
walls=4
0,0,30,1
0,0,1,20
0,19,30,1
29,0,1,20
spawn=5,9
enemies=27
20,4,0
25,7,1
24,8,1
4,9,1
26,15,0
26,4,0
3,4,0
3,15,0
24,5,1
4,5,1
24,12,1
4,12,1
26,15,0
26,4,0
3,4,0
3,15,0
26,8,0
4,8,0
25,9,1
15,9,1
5,9,1
25,4,1
15,4,1
5,4,1
25,14,1
15,14,1
5,14,1
waves=4
0,2,8,18