[Map]
tileSheet=Assets/World/NecroDungeon/TileSheet.png
name=NecroDungeon
tileWidth=16
tileHeight=16
scaleX=4
scaleY=4
mapWidth=30
mapHeight=17
tiles=
3,3,3,3,3,3,3,3,3,3,3,3,3,3,3,3,3,3,3,3,3,3,3,3,3,3,3,3,3,3
3,9,10,10,10,10,10,10,10,10,10,10,10,10,10,10,10,10,10,10,10,10,10,10,10,10,10,10,14,3
3,13,2,2,0,2,2,2,0,2,2,2,0,2,2,2,0,2,2,2,0,2,2,2,0,2,2,2,4,3
3,13,2,2,2,2,2,2,2,2,2,2,2,2,2,2,2,2,2,2,2,2,2,2,2,2,2,2,4,3
3,13,0,2,2,2,2,2,2,2,2,2,2,2,2,2,2,2,2,2,2,2,2,2,2,2,2,0,4,3
3,13,2,2,2,2,2,2,2,2,1,2,2,2,2,2,2,2,2,1,2,2,2,2,2,2,2,2,4,3
3,13,2,2,2,2,2,2,2,2,2,2,2,2,2,2,2,2,2,2,2,2,2,2,2,2,2,2,4,3
3,13,2,2,2,2,1,2,2,2,2,2,2,2,1,2,2,2,2,2,2,2,2,1,2,2,2,2,4,3
3,13,0,2,2,2,2,2,2,2,2,2,2,2,2,2,2,2,2,2,2,2,2,2,2,2,2,0,4,3
3,13,2,2,2,2,2,2,2,2,2,2,2,2,2,2,2,2,2,2,2,2,2,2,2,2,2,2,4,3
3,13,2,2,0,2,2,2,0,2,2,2,0,2,2,2,0,2,2,2,0,2,2,2,0,2,2,2,4,3
3,13,2,2,2,2,2,2,2,2,2,2,2,2,2,2,2,2,2,2,2,2,2,2,2,2,2,2,4,3
3,13,2,2,2,2,2,5,2,2,2,2,2,5,2,2,2,2,2,5,2,2,2,2,5,2,2,2,4,3
3,13,2,0,2,2,2,2,2,2,2,2,2,2,2,2,2,2,2,2,2,2,2,2,2,2,2,2,4,3
3,13,2,2,2,2,2,2,2,5,2,2,2,2,2,5,2,2,2,2,2,5,2,2,2,2,5,2,4,3
3,12,6,6,6,6,6,6,6,6,6,6,6,6,6,6,6,6,6,6,6,6,6,6,6,6,6,6,7,3
3,3,3,3,3,3,3,3,3,3,3,3,3,3,3,3,3,3,3,3,3,3,3,3,3,3,3,3,3,3
walls=4
0,0,30,1
0,0,1,17
0,16,30,1
29,0,1,17
spawn=13,8
enemies=34
15,3,0
15,14,0
23,9,1
2,9,1
23,9,2
2,9,1
8,3,1
15,3,1
8,14,1
15,14,1
5,7,3
2,3,1
23,3,0
2,14,0
23,14,1
2,14,0
2,3,0
23,14,0
23,3,0
8,14,0
8,2,0
13,14,0
13,2,0
3,9,0
22,9,0
5,9,0
22,9,0
10,7,0
16,7,0
16,11,0
10,11,0
3,9,3
23,9,3
13,9,2
waves=5
0,4,10,15,31