[Map]
tileSheet=Assets/World/NecroDungeon/TileSheet.png
name=NecroDungeon
tileWidth=16
tileHeight=16
scaleX=4
scaleY=4
mapWidth=30
mapHeight=17
tiles=
3,3,3,3,3,3,3,3,3,3,3,3,3,3,3,3,3,3,3,3,3,3,3,3,3,3,3,3,3,3
3,9,10,10,10,10,10,10,10,10,10,10,10,10,10,10,10,10,10,10,10,10,10,10,10,10,10,10,14,3
3,13,2,2,0,2,2,2,0,2,2,2,0,2,2,2,0,2,2,2,0,2,2,2,0,2,2,2,4,3
3,13,2,2,2,2,2,2,2,2,2,2,2,2,2,2,2,2,2,2,2,2,2,2,2,2,2,2,4,3
3,13,0,2,2,2,2,2,2,2,2,2,2,2,2,2,2,2,2,2,2,2,2,2,2,2,2,0,4,3
3,13,2,2,2,2,2,2,2,2,1,2,2,2,2,2,2,2,2,1,2,2,2,2,2,2,2,2,4,3
3,13,2,2,2,2,2,2,2,2,2,2,2,2,2,2,2,2,2,2,2,2,2,2,2,2,2,2,4,3
3,13,2,2,2,2,1,2,2,2,2,2,2,2,1,2,2,2,2,2,2,2,2,1,2,2,2,2,4,3
3,13,0,2,2,2,2,2,2,2,2,2,2,2,2,2,2,2,2,2,2,2,2,2,2,2,2,0,4,3
3,13,2,2,2,2,2,2,2,2,2,2,2,2,2,2,2,2,2,2,2,2,2,2,2,2,2,2,4,3
3,13,2,2,0,2,2,2,0,2,2,2,0,2,2,2,0,2,2,2,0,2,2,2,0,2,2,2,4,3
3,13,2,2,2,2,2,2,2,2,2,2,2,2,2,2,2,2,2,2,2,2,2,2,2,2,2,2,4,3
3,13,2,2,2,2,2,5,2,2,2,2,2,5,2,2,2,2,2,5,2,2,2,2,5,2,2,2,4,3
3,13,2,0,2,2,2,2,2,2,2,2,2,2,2,2,2,2,2,2,2,2,2,2,2,2,2,2,4,3
3,13,2,2,2,2,2,2,2,5,2,2,2,2,2,5,2,2,2,2,2,5,2,2,2,2,5,2,4,3
3,12,6,6,6,6,6,6,6,6,6,6,6,6,6,6,6,6,6,6,6,6,6,6,6,6,6,6,7,3
3,3,3,3,3,3,3,3,3,3,3,3,3,3,3,3,3,3,3,3,3,3,3,3,3,3,3,3,3,3
walls=4
0,0,30,1
0,0,1,17
0,16,30,1
29,0,1,17
spawn=14,8
enemies=17
20,3,0
9,3,0
23,7,0
6,7,0
23,11,0
6,11,0
20,13,0
9,13,0
23,5,0
23,10,0
25,9,2
3,3,1
25,3,1
3,13,1
25,13,1
5,9,2
23,9,2
waves=3
0,8,11