[Map]
tileSheet=Assets/World/NecroDungeon/TileSheet.png
name=NecroDungeon
tileWidth=16
tileHeight=16
scaleX=4
scaleY=4
mapWidth=30
mapHeight=20
tiles=
3,3,3,3,3,3,3,3,3,3,3,3,3,3,3,3,3,3,3,3,3,3,3,3,3,3,3,3,3,3
3,9,10,10,10,10,10,10,10,10,10,10,10,10,10,10,10,10,10,10,10,10,10,10,10,10,10,10,14,3
3,13,2,2,0,2,2,2,0,2,2,2,0,2,2,2,0,2,2,2,0,2,2,2,0,2,2,2,4,3
3,13,2,2,2,2,2,2,2,2,2,2,2,2,2,2,2,2,2,2,2,2,2,2,2,2,2,2,4,3
3,13,0,2,2,2,2,2,2,2,2,2,2,2,2,2,2,2,2,2,2,2,2,2,2,2,2,0,4,3
3,13,2,2,2,2,2,2,2,2,1,2,2,2,2,2,2,2,2,1,2,2,2,2,2,2,2,2,4,3
3,13,2,2,0,2,2,2,0,2,2,2,0,2,2,2,0,2,2,2,0,2,2,2,0,2,2,2,4,3
3,13,2,2,2,2,2,2,2,2,2,2,2,2,2,2,2,2,2,2,2,2,2,2,2,2,2,2,4,3
3,13,2,2,0,2,2,2,2,2,2,2,2,2,2,2,2,2,2,2,2,2,2,2,2,2,2,2,4,3
3,13,2,0,2,2,2,1,2,2,2,2,0,2,2,2,2,0,2,2,2,2,2,2,1,2,2,2,4,3
3,13,0,2,2,2,2,2,2,2,2,0,2,2,2,2,2,2,0,2,2,2,2,2,2,2,2,2,4,3
3,13,2,5,2,2,2,2,2,5,2,2,2,2,2,5,2,2,2,2,5,2,2,2,2,2,2,2,4,3
3,13,2,2,2,2,2,2,2,2,2,2,2,2,2,2,2,2,2,2,2,2,2,2,2,2,2,2,4,3
3,13,2,2,2,5,2,2,2,2,2,5,2,2,2,2,2,5,2,2,2,2,5,2,2,2,0,2,4,3
3,13,2,2,2,2,2,2,2,2,2,2,2,2,2,2,2,2,2,2,2,2,2,2,2,2,2,2,4,3
3,13,2,2,2,2,2,5,2,2,2,2,2,5,2,2,2,2,2,5,2,2,2,2,5,2,2,2,4,3
3,13,2,0,2,2,2,2,2,2,2,2,2,2,2,2,2,2,2,2,2,2,2,2,2,2,2,2,4,3
3,13,2,2,2,2,2,2,2,5,2,2,2,2,2,5,2,2,2,2,2,5,2,2,2,2,5,2,4,3
3,12,6,6,6,6,6,6,6,6,6,6,6,6,6,6,6,6,6,6,6,6,6,6,6,6,6,6,7,3
3,3,3,3,3,3,3,3,3,3,3,3,3,3,3,3,3,3,3,3,3,3,3,3,3,3,3,3,3,3
walls=4
0,0,30,1
0,0,1,20
0,19,30,1
29,0,1,20
spawn=5,9
enemies=2
25,3,0
25,9,1