[Map]
tileSheet=Assets/World/NecroDungeon/TileSheet.png
name=NecroDungeon
tileWidth=16
tileHeight=16
scaleX=4
scaleY=4
mapWidth=20
mapHeight=20
tiles=
7,7,7,7,7,7,7,7,7,7,7,7,7,7,7,7,7,7,7,7
3,2,2,2,2,2,2,2,2,2,2,2,2,2,2,2,2,2,2,4
3,2,1,2,1,2,0,2,2,2,1,2,1,2,2,5,5,5,2,4
3,2,2,1,2,0,2,0,2,2,2,0,2,2,2,5,5,5,2,4
3,2,2,2,2,2,2,2,2,2,1,2,1,2,2,5,5,5,2,4
3,2,2,2,1,2,0,2,0,2,2,2,2,2,2,2,2,2,2,4
3,2,2,1,2,1,2,1,2,2,2,2,2,2,2,2,2,2,2,4
3,2,2,2,1,2,0,2,0,2,2,2,2,2,2,2,2,2,2,4
3,2,2,2,2,2,2,2,2,2,2,2,2,2,2,2,2,2,2,4
3,7,7,7,7,7,7,8,8,8,8,8,8,7,7,7,7,7,7,4
3,6,6,6,6,6,6,8,8,8,8,8,8,6,6,6,6,6,6,4
3,2,2,2,2,2,2,2,2,2,2,2,2,2,2,2,2,2,2,4
3,2,2,2,2,2,2,2,2,2,2,2,2,2,2,2,2,2,2,4
3,2,2,2,2,2,2,2,2,2,2,2,2,2,2,2,2,2,2,4
3,2,2,2,2,2,2,2,2,2,2,2,2,2,2,2,2,2,2,4
3,2,2,2,2,2,2,2,2,2,2,2,2,2,2,2,2,2,2,4
3,2,2,2,2,2,2,2,2,2,2,2,2,2,2,2,2,2,2,4
3,2,2,2,2,2,2,2,2,2,2,2,2,2,2,2,2,2,2,4
3,2,2,2,2,2,2,2,2,2,2,2,2,2,2,2,2,2,2,4
6,6,6,6,6,6,6,6,6,6,6,6,6,6,6,6,6,6,6,6